X----------X
|          |
| XXXXXXXX |
|        X |
|X   XXXXX |
  X  X     |
  X  XX X X|
|   X   X  |
| X X   X  |
| XX  X X  |
|    X     |
X----  ----X
