X----  ----X
| X X  X   |
|      X X 
|X XX      |
|     XXX X|
| XXXXX X  |
|        X 
| XXXXXX   |
| X X   XX |
| X X X X  |
|   X X   X|
X----  ----X