X----  ----X
|    X     |
|  X XXXX  |
|  X X     |
|  X X XXXX|
|  X   X    
|      X XX 
|XX    X   |
|   XX XX X|
|  X    X  |
|    X     |
X----------X
