X----------X
|XXXXXXXXXX|
|X  X     X|
|XX X X X X|
|XX XXX X X|
|XX   X     
|XX X    XX 
|XX XXXXXX |
|XX X  X   |
|X   X XXX |
|X X       |
X----  ----X