X----  ----X
|X        X|
|XXXXXX XXX|
|X  X    XX|
|X XXXXX  X|
      X   X|
  X XX  XXX|
|XX  XX  XX|
|  X  X    |
|  XX XXXX |
|  X       |
X----------X
