X----  ----X
|XXXXX    X|
|XX     X  |
|X  X X XX |
|  XX X XX |
 XXXXXXXXX |
  X X   X  |
| X     XX |
| X XXX XX |
| X     XX |
| XX      X|
X----------X
